ETA,A_1982,A_1983,A_1984,A_1985,A_1986,A_1987,A_1988,A_1989,A_1990,A_1991,A_1992,A_1993,A_1994,A_1995,A_1996,A_1997,A_1998,A_1999,A_2000,A_2001,A_2002,A_2003,A_2004,A_2005,A_2006,A_2007,A_2008,A_2009,A_2010,A_2011,A_2012,A_2013,A_2014,A_2015,A_2016,A_2017
0,9,10,18,11,16,8,16,18,24,11,14,8,6,13,15,16,8,14,15,6,7,3,8,5,5,5,15,8,3,5,7,3,8,5,5,5
1,16,8,9,18,11,14,7,16,16,23,14,14,8,6,13,16,16,8,14,14,5,7,3,8,5,5,5,15,8,2,7,7,3,8,5,5
2,8,16,8,8,19,11,13,7,17,15,20,13,15,9,6,13,16,15,8,14,14,5,6,3,8,6,5,5,13,8,13,6,6,3,8,5
3,20,6,14,8,10,18,10,13,6,16,16,18,13,14,8,6,13,15,15,7,14,14,5,6,3,8,5,5,5,13,13,13,6,6,3,8
4,18,19,6,14,9,10,19,10,15,7,17,16,17,13,13,8,6,13,15,16,8,14,13,5,6,3,8,5,5,4,8,13,12,6,6,3
5,13,19,19,8,14,9,6,19,11,14,8,17,16,16,12,14,8,6,12,16,16,8,14,13,5,6,3,8,5,5,15,8,13,12,6,6
6,21,12,18,20,6,17,9,7,19,10,16,8,15,16,16,11,15,8,7,12,16,16,8,14,13,5,6,3,7,5,14,17,8,13,12,6
7,18,22,13,18,21,7,15,12,6,21,12,16,8,15,16,16,11,14,8,7,11,16,16,7,14,13,5,6,3,7,11,15,17,7,13,12
8,8,17,21,14,18,22,7,15,11,6,19,11,16,8,15,16,16,11,14,8,6,11,14,14,7,14,13,7,6,3,6,11,13,15,7,13
9,18,9,18,21,14,17,22,6,14,12,6,18,11,16,8,15,16,16,11,14,8,6,11,14,14,7,14,12,7,6,9,6,11,13,15,7
10,20,18,9,18,21,15,16,22,7,13,11,6,18,11,16,6,15,16,16,11,15,8,6,11,14,14,7,13,12,7,14,8,6,11,13,15
11,14,20,20,9,19,21,16,16,22,6,15,9,6,17,11,15,6,15,16,16,10,15,8,7,11,14,14,7,13,12,10,14,8,7,11,13
12,23,13,20,19,10,19,21,16,13,23,7,12,9,6,17,10,15,5,15,16,15,10,15,9,7,11,14,14,7,13,14,10,14,9,7,11
13,13,24,13,20,19,11,20,21,16,12,23,7,12,9,6,17,10,16,5,15,16,15,10,15,9,7,11,12,14,7,15,15,10,14,9,7
14,10,14,23,13,20,19,11,20,21,15,12,24,7,14,9,6,15,10,16,5,15,16,15,10,15,9,7,12,12,14,13,17,15,10,14,9
15,20,10,14,23,13,20,21,12,21,21,15,12,24,8,14,7,8,16,9,16,5,15,16,15,10,15,9,7,12,12,7,15,17,15,10,14
16,27,19,10,13,24,13,20,20,12,21,20,15,12,21,8,14,7,8,16,9,16,5,15,16,15,11,15,9,7,12,14,6,15,16,15,10
17,33,26,18,9,14,23,13,20,21,14,19,20,15,12,20,9,13,7,8,16,9,16,5,15,16,15,11,15,9,7,9,15,6,15,16,15
18,23,30,26,19,9,16,22,13,19,21,13,19,19,17,12,20,9,12,7,8,16,9,16,5,15,18,15,11,15,9,13,9,15,6,15,18
19,21,21,29,24,19,8,18,22,15,18,20,11,20,17,16,13,21,8,11,7,7,16,9,17,5,15,17,14,11,15,7,15,9,16,6,15
20,26,19,20,29,21,16,8,15,22,15,18,20,11,19,17,17,15,21,8,10,7,7,16,9,17,5,14,17,14,11,7,7,15,9,16,6
21,20,24,20,20,31,20,15,8,15,23,15,17,16,10,18,16,15,14,21,8,9,8,7,17,9,16,4,13,17,14,9,8,7,16,9,16
22,23,18,24,19,20,30,18,16,8,14,19,14,21,17,10,19,15,14,14,21,9,9,8,7,17,8,15,4,13,16,7,9,7,7,16,8
23,11,20,17,21,18,20,29,17,13,7,15,17,13,20,17,9,18,14,13,14,20,9,9,5,7,17,7,15,4,13,19,7,9,5,7,16
24,16,11,23,18,19,18,17,27,17,13,8,14,18,13,19,18,9,17,16,12,12,18,8,9,6,7,17,7,15,4,11,19,6,9,6,7
25,13,16,10,20,16,17,20,17,24,16,13,6,12,16,15,18,16,7,16,16,10,13,19,4,7,6,6,18,7,14,13,12,19,4,8,6
26,26,12,15,9,22,17,16,21,17,22,16,13,6,13,17,14,19,14,7,15,16,9,12,18,4,7,6,7,14,7,14,12,11,18,4,8
27,19,23,12,16,11,21,16,15,21,16,24,16,13,6,14,19,15,17,14,7,15,13,9,12,17,3,7,6,7,13,14,13,12,11,17,4
28,18,18,23,13,14,10,21,14,16,20,16,24,15,12,6,14,18,15,16,15,8,15,13,10,12,16,3,6,6,5,10,15,13,12,11,16
29,11,17,18,22,12,14,9,22,14,16,20,14,24,12,12,6,11,19,15,16,13,7,15,12,11,13,14,3,6,6,14,9,15,12,12,12
30,14,10,17,16,22,12,14,9,22,13,17,20,13,23,11,13,6,10,19,14,16,13,7,13,13,11,13,15,3,5,19,14,9,14,12,11
31,10,15,10,16,15,21,13,13,9,20,14,17,21,13,23,11,15,6,9,19,14,14,12,7,12,12,12,12,16,3,13,17,12,8,13,12
32,16,10,13,11,15,14,20,13,10,9,19,12,16,21,13,22,10,15,7,9,19,13,12,12,6,11,10,10,11,14,16,13,15,13,8,13
33,16,16,8,13,11,14,13,18,12,10,11,19,12,16,21,13,20,9,15,7,9,17,11,12,11,6,12,11,9,11,11,15,12,15,13,8
34,6,16,16,10,14,10,13,12,15,11,9,10,19,10,17,20,11,19,9,14,7,9,16,12,11,10,7,12,10,9,8,11,15,15,14,12
35,11,5,17,15,10,14,10,12,12,16,10,8,9,19,10,17,20,11,17,10,14,7,9,14,12,11,11,8,13,10,13,8,11,12,12,14
36,6,12,4,18,15,9,14,10,13,12,16,11,8,11,18,12,17,20,10,16,10,12,6,9,14,10,12,11,8,12,11,12,7,14,14,11
37,10,7,10,4,18,13,9,14,13,11,12,15,11,8,9,18,12,17,17,11,15,9,12,5,9,14,10,14,11,8,15,10,12,9,10,14
38,6,9,6,10,6,16,13,8,15,11,12,9,14,9,8,10,18,14,17,17,9,15,9,11,5,9,13,11,15,10,11,15,10,5,5,10
39,5,6,9,6,10,4,14,13,6,15,13,10,9,14,9,8,10,19,14,17,17,8,15,10,11,5,9,13,11,13,17,9,15,11,11,5
40,9,4,6,8,6,10,3,14,12,6,14,13,10,9,14,8,8,10,18,13,15,17,9,15,8,11,5,10,12,11,13,19,10,10,10,10
41,15,10,5,6,9,6,9,4,15,12,6,13,13,10,9,15,7,9,11,18,14,15,17,9,16,8,11,5,10,12,13,12,19,15,15,10
42,21,17,9,5,5,9,6,9,4,15,13,6,13,13,10,9,14,7,9,11,18,14,16,17,9,17,8,11,5,9,18,13,14,10,10,16
43,13,20,14,8,5,5,9,7,10,4,14,13,6,13,13,10,9,14,7,9,10,17,13,15,17,10,17,9,11,5,10,19,12,18,17,10
44,15,11,21,14,8,5,5,8,6,9,5,12,13,6,13,10,10,9,14,7,9,10,18,13,14,17,10,15,11,11,8,10,20,13,13,17
45,8,12,12,21,13,8,5,5,7,6,10,5,12,13,6,13,10,10,9,14,7,9,10,17,12,14,16,10,15,11,10,7,10,12,12,14
46,9,7,12,11,20,11,7,5,5,6,8,10,5,13,14,6,12,10,10,9,14,7,9,10,18,11,13,17,10,15,14,8,7,18,18,11
47,11,9,7,12,12,19,11,6,6,5,5,8,10,5,13,14,6,11,10,10,9,15,7,9,10,18,11,13,17,10,12,15,8,10,10,18
48,16,12,9,7,13,11,20,11,6,6,5,5,8,10,5,13,14,6,12,10,9,9,15,7,8,10,17,11,13,17,10,12,15,7,7,10
49,15,14,10,9,7,12,11,21,10,6,6,5,4,8,10,5,12,12,6,12,10,9,10,15,8,8,10,18,12,12,10,9,12,8,8,7
50,10,15,16,10,10,6,12,11,19,9,6,6,3,4,8,10,5,12,12,6,11,10,9,11,15,8,7,10,17,12,11,10,9,13,15,8
51,23,11,15,14,10,10,7,12,11,20,10,6,5,3,4,7,11,5,12,12,6,10,10,9,12,15,10,7,10,17,6,10,10,9,13,15
52,11,21,10,15,13,10,10,6,12,11,19,10,6,5,3,5,7,9,5,12,12,6,10,10,9,12,15,11,7,9,12,6,10,10,9,13
53,12,10,22,10,15,13,11,9,6,12,11,19,10,6,5,3,5,7,9,5,12,11,7,10,10,9,13,15,11,7,13,11,6,10,10,9
54,5,11,10,19,13,14,13,10,10,6,13,11,19,10,6,5,3,5,7,9,5,12,11,7,10,10,9,13,15,10,5,13,11,6,10,11
55,11,4,12,10,19,12,14,13,10,9,6,13,11,18,10,6,5,2,3,7,9,6,12,11,8,10,9,9,12,15,9,6,13,11,7,10
56,12,10,4,11,11,17,11,14,12,9,9,6,13,11,17,10,5,5,3,3,8,9,6,12,11,8,11,9,10,12,7,9,6,13,11,7
57,12,12,10,4,10,11,17,11,15,10,10,9,6,13,11,16,9,5,5,3,4,8,9,6,12,11,7,11,9,10,5,7,9,6,13,11
58,14,10,12,10,4,10,11,17,11,13,12,10,9,6,12,11,16,9,5,5,3,4,8,9,6,11,11,7,9,9,5,4,7,9,6,12
59,17,15,10,10,10,5,10,11,15,11,14,12,10,8,6,11,11,16,8,5,5,3,4,8,10,6,12,11,6,9,4,4,4,7,10,6
60,12,18,14,10,11,10,5,10,11,15,11,14,12,11,8,5,11,11,16,8,5,5,3,4,6,10,6,12,11,6,4,4,4,4,5,10
61,17,13,18,13,10,11,10,5,9,9,16,11,14,11,11,8,5,11,10,16,8,5,5,3,4,6,10,6,12,11,9,4,4,4,4,5
62,13,18,14,17,12,10,10,10,6,8,9,16,10,14,11,12,8,6,11,10,16,7,5,5,3,4,4,10,6,12,17,7,4,4,4,4
63,8,12,16,13,16,12,10,10,11,6,9,9,15,10,14,11,12,8,6,10,11,16,7,5,5,3,4,4,9,6,11,16,7,4,4,4
64,13,8,12,16,12,16,12,10,10,11,8,9,9,16,9,14,11,11,8,6,10,11,16,7,5,5,4,4,4,9,12,11,16,7,4,4
65,13,12,8,12,17,12,15,11,10,8,11,8,9,9,18,9,16,11,11,7,6,9,11,16,7,5,5,4,3,4,6,8,11,16,7,4
66,9,14,12,8,12,17,13,14,12,10,11,11,8,9,9,18,8,16,11,11,6,6,9,11,16,7,5,5,4,3,6,6,8,11,16,7
67,9,9,13,12,8,13,17,14,13,10,10,10,11,8,7,9,17,8,16,11,11,6,6,9,13,16,7,5,4,4,12,6,6,8,12,16
68,21,8,7,11,12,8,13,16,14,13,10,10,8,11,8,7,9,18,8,16,11,10,6,7,9,13,15,7,4,4,13,11,6,7,8,12
69,19,21,8,6,11,12,8,13,16,14,13,10,10,9,11,8,7,8,18,8,16,11,10,6,7,9,13,15,7,4,14,12,11,5,7,8
70,13,20,21,9,6,11,12,7,13,14,14,12,10,10,9,11,8,7,6,18,8,13,11,11,6,7,9,13,14,7,9,13,12,12,5,7
71,14,11,19,20,10,6,12,13,7,12,16,11,12,10,10,7,11,8,5,6,18,8,13,10,11,6,6,9,12,13,17,9,13,11,11,5
72,10,12,11,19,19,9,8,11,12,7,12,16,11,9,10,10,7,11,8,5,6,18,8,12,10,11,7,6,7,12,7,18,9,12,10,11
73,10,10,12,12,19,18,9,7,11,13,6,11,16,8,9,10,10,7,11,8,4,6,16,9,9,10,11,7,6,6,3,6,16,10,10,10
74,9,9,10,12,10,19,18,10,5,11,13,6,10,16,8,9,9,10,7,10,7,5,5,15,9,9,10,10,6,6,6,5,5,15,9,10
75,6,8,8,10,12,10,17,17,10,5,12,13,5,10,14,7,9,9,10,7,10,7,5,5,14,9,8,10,9,5,11,6,5,5,14,9
76,13,6,8,7,9,12,11,16,15,9,5,12,11,5,10,14,7,9,9,10,6,11,7,5,5,11,8,8,10,9,6,11,6,5,6,12
77,15,13,6,8,7,8,12,9,17,14,9,5,8,11,5,10,13,7,9,8,9,5,11,7,4,5,10,7,8,10,9,6,11,6,4,5
78,9,14,14,7,9,7,9,13,8,17,13,8,5,7,11,4,9,11,7,8,8,9,4,10,7,4,5,10,7,8,7,9,5,10,6,4
79,5,9,13,12,5,8,7,8,12,8,16,13,7,4,6,11,3,9,8,7,7,6,9,4,10,6,4,5,10,7,9,6,9,5,10,5
80,7,4,8,13,10,4,8,5,8,12,9,16,13,7,4,5,8,3,8,6,7,6,6,10,5,9,5,4,5,10,7,7,6,9,6,9
81,7,3,4,7,11,9,4,7,5,9,13,8,15,13,7,4,3,6,3,8,6,6,6,6,10,5,9,5,4,5,7,5,7,6,9,5
82,5,5,4,4,7,9,10,4,8,5,8,12,8,15,13,6,3,3,5,3,8,5,3,6,6,8,5,9,3,4,7,6,3,7,6,8
83,7,6,5,3,4,8,9,9,4,7,5,8,12,8,14,12,6,3,3,5,3,8,4,3,6,6,8,5,7,3,2,6,5,3,7,6
84,6,4,4,5,2,4,6,9,8,3,5,5,8,10,7,14,12,6,3,3,4,3,8,2,2,6,6,8,4,8,5,2,5,4,2,7
85,3,3,4,4,5,5,6,6,6,8,4,4,5,7,10,6,13,8,5,3,3,2,1,8,2,2,5,4,8,3,4,2,1,9,4,2
86,3,3,3,4,4,4,6,4,5,6,9,1,4,4,4,11,5,11,6,5,3,2,2,1,8,3,2,5,4,7,3,4,3,1,9,4
87,2,2,3,3,3,3,5,4,4,5,5,10,1,4,3,4,8,5,11,6,2,3,2,2,1,8,3,2,6,4,1,3,3,3,1,9
88,2,2,2,3,3,3,3,3,4,4,2,6,10,1,2,3,4,8,3,10,6,1,3,1,2,1,7,3,2,6,6,1,2,2,3,1
89,2,2,2,2,2,2,3,2,3,4,1,2,6,9,1,2,1,4,4,3,8,3,1,1,1,2,1,7,2,2,7,4,2,1,2,3
90,2,2,2,3,3,3,3,2,2,3,1,1,2,4,7,0,1,0,4,3,2,7,1,0,1,1,1,1,4,3,3,6,3,1,1,2
91,1,1,1,1,2,2,1,2,2,2,1,1,1,2,4,6,0,0,0,4,2,1,4,1,0,1,1,1,0,4,2,1,4,2,1,1
92,1,1,1,1,1,1,1,1,1,1,0,1,1,1,2,2,3,0,0,0,4,1,1,4,1,0,1,1,2,0,4,1,1,4,2,1
93,0,1,1,1,1,1,1,1,1,1,2,0,1,1,1,2,2,3,0,0,0,4,1,1,3,1,0,1,2,2,0,3,1,1,3,2
94,0,0,0,0,1,1,1,1,1,1,0,1,1,0,1,1,2,1,2,0,0,0,4,1,1,2,1,0,0,2,0,0,3,1,1,2
95,0,0,0,0,0,0,0,1,1,1,0,0,0,1,0,1,1,0,1,2,0,0,0,4,1,0,2,1,0,0,0,0,0,3,1,0
96,0,0,0,0,0,0,0,0,0,0,2,0,0,0,1,0,1,1,0,1,2,0,0,0,3,1,0,1,0,0,2,0,0,0,2,1
97,0,0,0,0,0,0,0,0,0,0,0,2,0,0,0,0,0,0,0,0,0,2,0,0,0,3,1,0,1,0,0,2,0,0,0,2
98,0,0,0,0,0,0,0,0,0,0,0,0,0,0,0,0,0,0,0,0,0,0,1,0,0,0,2,1,0,1,0,0,0,0,0,0
99,0,0,0,0,0,0,0,0,0,0,1,0,0,0,0,0,0,0,0,0,0,0,0,1,0,0,0,1,1,0,0,0,0,1,0,0
